#  #  #  #  #
#  .  b  .  #
#  .  #  .  #
#  .  c  .  #
#  #  #  #  #