#  #  #  #  #  #  #  #  #  #  |
#  c  .  .  .  .  .  .  .  #  |
#  .  #  #  #  .  #  #  .  #  |
#  .  .  .  .  .  #  .  o  #  |
#  #  #  .  #  .  #  .  #  #  |
#  .  .  .  #  .  .  .  .  #  |
#  o  #  #  #  #  #  #  .  #  |
#  .  .  .  .  .  .  .  b  #  |
#  #  #  #  #  #  #  #  #  #  |