#  #  #  #  #
#  .  m  .  #
#  o  #  o  #
#  .  c  .  #
#  #  #  #  #