#  #  #  #  #
#  #  s  #  #
#  .  c  .  #
#  #  o  #  #
#  #  #  #  #