#  #  #  #  #
#  .  m  .  #
#  .  #  .  #
#  .  c  .  #
#  #  #  #  #