#  #  #  #  #
#  #  .  #  #
#  .  c  .  #
#  #  .  #  #
#  #  #  #  #