# # # # #
# # s # #
# . c . #
# # o # #
# # # # #