# # # # #
# . b . #
# . # . #
# . c . #
# # # # #