# # # . # #
# # # . # #
. . # c . .
# s # # # #
# . # . o #
# # # . # #