# # # # #
# # . # #
# . c . #
# # . # #
# # # # #