#  #  #  #  #
#  .  b  .  #
#  o  #  o  #
#  .  c  .  #
#  #  #  #  #