# # # # #
# . b . #
# o # o #
# . c . #
# # # # #