#  #  #  .  #  #
#  #  #  .  #  #
.  .  #  c  .  .
#  s  #  #  #  #
#  .  #  .  o  #
#  #  #  .  #  #