  # # # # # # # # # # # # # # # # # # # |
  # . . . . . . . . # . . . . . . . . # |
  # o # # . # # # . # . # # # . # # o # |
  # . . . . . . . . . . . . . . . . . # |
  # . # # . # . # # # # # . # . # # . # |
  # . . . . # . . . # . . . # . . . . # |
  # # # # . # # #   #   # # # . # # # # |
        # . #               # . #       |
# # # # # . #   # # b # #   # . # # # # #
          .     # i p y #   # .         |
# # # # # . #   # # # # #   # . # # # # #
        # . #               # . #       |
  # # # # . #   # # # # #   # . # # # # |
  # . . . . . . . . # . . . . . . . . # |
  # . # # . # # # . # . # # # . # # . # |
  # o . # . . . . . c . . . . . # . o # |
  # # . # . # . # # # # # . # . # . # # |
  # . . . . # . . . # . . . # . . . . # |
  # . # # # # # # . # . # # # # # # . # |
  # . . . . . . . . . . . . . . . . . # |
  # # # # # # # # # # # # # # # # # # # |