#  #  #  #  #  #  |
#  c  .  .  .  #  |
#  .  #  #  .  #  |
.  .  #  .  o  .  |
#  .  #  .  #  #  |
#  .  .  .  b  #  |
#  #  #  #  #  #  |