# # # # # # |
# c . . . # |
# . # # . # |
. . # . o . |
# . # . # # |
# . . . b # |
# # # # # # |