# # # # # # # # # # |
# c . . . . . . . # |
# . # # # . # # . # |
# . . . . . # . o # |
# # # . # . # . # # |
# . . . # . . . . # |
# o # # # # # # . # |
# . . . . . . . b # |
# # # # # # # # # # |